Rank,Title,Worldwide Lifetime Gross,Domestic Lifetime Gross,Domestic %,Foreign Lifetime Gross,Foreign %,Year
345,Gone with the Wind,402382193,200882193,0.50,201500000,0.50,1939
618,Bambi,267447150,102247150,0.38,165200000,0.62,1942
670,The Godfather,250341816,136381073,0.55,113960743,0.46,1972
298,The Exorcist,441306145,233005644,0.53,208300501,0.47,1973
259,Jaws,476512065,265859065,0.56,210653000,0.44,1975
112,Star Wars: Episode IV - A New Hope,775398007,460998507,0.59,314399500,0.41,1977
526,Close Encounters of the Third Kind,306889114,135189114,0.44,171700000,0.56,1977
720,Saturday Night Fever,237113184,94213184,0.40,142900000,0.60,1977
352,Grease,396271103,190071103,0.48,206200000,0.52,1978
541,Superman,300478449,134478449,0.45,166000000,0.55,1978
217,Star Wars: Episode V - The Empire Strikes Back,538375067,292753960,0.54,245621107,0.46,1980
359,Raiders of the Lost Ark,389925971,248159971,0.64,141766000,0.36,1981
104,E.T. the Extra-Terrestrial,792910554,437141279,0.55,355769275,0.45,1982
262,Star Wars: Episode VI - Return of the Jedi,475106177,316566101,0.67,158540076,0.33,1983
471,Indiana Jones and the Temple of Doom,333107271,179870271,0.54,153237000,0.46,1984
505,Beverly Hills Cop,316360478,234760478,0.74,81600000,0.26,1984
557,Ghostbusters,296578797,243578797,0.82,53000000,0.18,1984
371,Back to the Future,383336762,212836762,0.56,170500000,0.45,1985
542,Rocky IV,300473716,127873716,0.43,172600000,0.57,1985
543,Rambo: First Blood Part II,300400432,150415432,0.50,149985000,0.50,1985
754,Out of Africa,227514205,87071205,0.38,140443000,0.62,1985
421,Top Gun,357288178,180258178,0.50,177030000,0.50,1986
482,Crocodile Dundee,328203506,174803506,0.53,153400000,0.47,1986
499,Fatal Attraction,320145693,156645693,0.49,163500000,0.51,1987
547,Beverly Hills Cop II,299965036,153665036,0.51,146300000,0.49,1987
426,Rain Man,354825435,172825435,0.49,182000000,0.51,1988
478,Who Framed Roger Rabbit,329803958,156452370,0.47,173351588,0.53,1988
573,Coming to America,288752301,128152301,0.44,160600000,0.56,1988
712,Crocodile Dundee II,239606210,109306210,0.46,130300000,0.54,1988
265,Indiana Jones and the Last Crusade,474171806,197171806,0.42,277000000,0.58,1989
328,Batman,411569241,251409241,0.61,160160000,0.39,1989
473,Back to the Future Part II,332500002,119000002,0.36,213500000,0.64,1989
555,Look Who's Talking,296999813,140088813,0.47,156911000,0.53,1989
725,Dead Poets Society,235860116,95860116,0.41,140000000,0.59,1989
752,Lethal Weapon 2,227853986,147253986,0.65,80600000,0.35,1989
775,Honey  I Shrunk the Kids,222724172,130724172,0.59,92000000,0.41,1989
235,Ghost,505703557,217631306,0.43,288072251,0.57,1990
258,Home Alone,476684675,285761243,0.60,190923432,0.40,1990
276,Pretty Woman,463406268,178406268,0.39,285000000,0.62,1990
317,Dances with Wolves,424208848,184208848,0.43,240000000,0.57,1990
634,Total Recall,261317921,119412921,0.46,141905000,0.54,1990
692,Back to the Future Part III,245077583,88277583,0.36,156800000,0.64,1990
711,Die Hard 2,240031274,117540947,0.49,122490327,0.51,1990
780,Presumed Innocent,221303188,86303188,0.39,135000000,0.61,1990
232,Terminator 2: Judgment Day,520881154,205881154,0.40,315000000,0.61,1991
316,Beauty and the Beast,424967620,218967620,0.52,206000000,0.49,1991
358,Robin Hood: Prince of Thieves,390493908,165493908,0.42,225000000,0.58,1991
540,Hook,300854823,119654823,0.40,181200000,0.60,1991
605,The Silence of the Lambs,272742922,130742922,0.48,142000000,0.52,1991
236,Aladdin,504050219,217350219,0.43,286700000,0.57,1992
329,The Bodyguard,411046449,122046449,0.30,289000000,0.70,1992
418,Home Alone 2: Lost in New York,358994850,173585516,0.48,185409334,0.52,1992
430,Basic Instinct,352927224,117727224,0.33,235200000,0.67,1992
494,Lethal Weapon 3,321731527,144731527,0.45,177000000,0.55,1992
620,Batman Returns,266934688,162924631,0.61,104010057,0.39,1992
699,A Few Good Men,243240178,141340178,0.58,101900000,0.42,1992
740,Sister Act,231605150,139605150,0.60,92000000,0.40,1992
34,Jurassic Park,1113138548,407185075,0.37,705953473,0.63,1993
299,Mrs. Doubtfire,441286195,219195243,0.50,222090952,0.50,1993
398,The Fugitive,368875760,183875760,0.50,185000000,0.50,1993
491,Schindler's List,322161245,96898818,0.30,225262427,0.70,1993
609,The Firm,270248367,158348367,0.59,111900000,0.41,1993
621,Indecent Proposal,266614059,106614059,0.40,160000000,0.60,1993
654,Cliffhanger,255000211,84049211,0.33,170951000,0.67,1993
751,Sleepless in Seattle,227927165,126808165,0.56,101119000,0.44,1993
57,The Lion King,968511805,422783777,0.44,545728028,0.56,1994
151,Forrest Gump,678226465,330455270,0.49,347771195,0.51,1994
379,True Lies,378882411,146282411,0.39,232600000,0.61,1994
438,The Mask,351583407,119938730,0.34,231644677,0.66,1994
440,Speed,350448145,121248145,0.35,229200000,0.65,1994
456,The Flintstones,341631208,130531208,0.38,211100000,0.62,1994
680,Dumb and Dumber,247290327,127190327,0.51,120100000,0.49,1994
685,Four Weddings and a Funeral,245700832,52700832,0.21,193000000,0.79,1994
771,Interview with the Vampire: The Vampire Chronicles,223664608,105264608,0.47,118400000,0.53,1994
354,Toy Story,394436586,223225679,0.57,171210907,0.43,1995
403,Die Hard with a Vengeance,366101666,100012499,0.27,266089167,0.73,1995
425,Apollo 13,355237933,173837933,0.49,181400000,0.51,1995
434,GoldenEye,352194034,106429941,0.30,245764093,0.70,1995
451,Pocahontas,346079773,141579773,0.41,204500000,0.59,1995
461,Batman Forever,336567158,184069126,0.55,152498032,0.45,1995
484,Se7en,327333559,100125643,0.31,227207916,0.69,1995
577,Casper,287928194,100328194,0.35,187600000,0.65,1995
625,Waterworld,264218220,88246220,0.33,175972000,0.67,1995
629,Jumanji,262821940,100499940,0.38,162322000,0.62,1995
656,Babe,254134910,63658910,0.25,190476000,0.75,1995
97,Independence Day,817400891,306169268,0.38,511231623,0.63,1996
243,Twister,494580615,241830615,0.49,252750000,0.51,1996
282,Mission: Impossible,457696391,180981856,0.40,276714535,0.61,1996
465,The Rock,335062621,134069511,0.40,200993110,0.60,1996
487,The Hunchback of Notre Dame,325338851,100138851,0.31,225200000,0.69,1996
497,101 Dalmatians,320689294,136189294,0.43,184500000,0.58,1996
519,Ransom,309492681,136492681,0.44,173000000,0.56,1996
601,The Nutty Professor,273961019,128814019,0.47,145147000,0.53,1996
602,Jerry Maguire,273552592,153952592,0.56,119600000,0.44,1996
704,Eraser,242295562,101295562,0.42,141000000,0.58,1996
739,The English Patient,231976425,78676425,0.34,153300000,0.66,1996
744,Space Jam,230594962,90594962,0.39,140000000,0.61,1996
4,Titanic,2264743305,674292608,0.30,1590450697,0.70,1997
177,The Lost World: Jurassic Park,618638999,229086679,0.37,389552320,0.63,1997
187,Men in Black,589390539,250690539,0.43,338700000,0.58,1997
472,Tomorrow Never Dies,333011068,125304276,0.38,207706792,0.62,1997
506,Air Force One,315156409,172956409,0.55,142200000,0.45,1997
510,As Good as It Gets,314178011,148478011,0.47,165700000,0.53,1997
536,Liar Liar,302710615,181410615,0.60,121300000,0.40,1997
549,My Best Friend's Wedding,299288605,127120029,0.43,172168576,0.58,1997
628,The Fifth Element,263920180,63820180,0.24,200100000,0.76,1997
643,The Full Monty,257938649,45950122,0.18,211988527,0.82,1997
660,Hercules,252712101,99112101,0.39,153600000,0.61,1997
664,Bean,251212670,45319423,0.18,205893247,0.82,1997
686,Face/Off,245676146,112276146,0.46,133400000,0.54,1997
715,Batman & Robin,238253988,107353792,0.45,130900196,0.55,1997
764,Good Will Hunting,225933435,138433435,0.61,87500000,0.39,1997
770,Con Air,224012234,101117573,0.45,122894661,0.55,1997
204,Armageddon,553709788,201578182,0.36,352131606,0.64,1998
255,Saving Private Ryan,482349603,217049603,0.45,265300000,0.55,1998
378,Godzilla,379014294,136314294,0.36,242700000,0.64,1998
396,There's Something About Mary,369884651,176484651,0.48,193400000,0.52,1998
408,A Bug's Life,363258859,162798565,0.45,200460294,0.55,1998
443,Deep Impact,349464664,140464664,0.40,209000000,0.60,1998
532,Mulan,304320254,120620254,0.40,183700000,0.60,1998
562,Doctor Dolittle,294456605,144156605,0.49,150300000,0.51,1998
571,Shakespeare in Love,289317794,100317794,0.35,189000000,0.65,1998
583,Lethal Weapon 4,285444603,130444603,0.46,155000000,0.54,1998
626,The Truman Show,264118712,125618201,0.48,138500511,0.52,1998
666,Enemy of the State,250849789,111549836,0.45,139299953,0.56,1998
667,You've Got Mail,250821495,115821495,0.46,135000000,0.54,1998
671,The Mask of Zorro,250288523,94095523,0.38,156193000,0.62,1998
695,Rush Hour,244721064,141186864,0.58,103534200,0.42,1998
745,Life Is Beautiful,230099013,57563264,0.25,172535749,0.75,1998
791,The Prince of Egypt,218613188,101413188,0.46,117200000,0.54,1998
48,Star Wars: Episode I - The Phantom Menace,1027082707,474544677,0.46,552538030,0.54,1999
153,The Sixth Sense,672806432,293506292,0.44,379300140,0.56,1999
240,Toy Story 2,497375381,245852179,0.49,251523202,0.51,1999
275,The Matrix,467222728,172076928,0.37,295145800,0.63,1999
292,Tarzan,448191819,171091819,0.38,277100000,0.62,1999
322,The Mummy,415933406,155385488,0.37,260547918,0.63,1999
407,Notting Hill,363889678,116089678,0.32,247800000,0.68,1999
413,The World Is Not Enough,361832400,126943684,0.35,234888716,0.65,1999
424,American Beauty,356296601,130096601,0.37,226200000,0.64,1999
511,Austin Powers: The Spy Who Shagged Me,313701294,206040086,0.66,107661208,0.34,1999
520,Runaway Bride,309460292,152257509,0.49,157202783,0.51,1999
546,Stuart Little,300135367,140035367,0.47,160100000,0.53,1999
580,The Green Mile,286801374,136801374,0.48,150000000,0.52,1999
675,The Blair Witch Project,248639099,140539099,0.57,108100000,0.44,1999
727,American Pie,235483004,102561004,0.44,132922000,0.56,1999
729,Big Daddy,234801895,163479795,0.70,71322100,0.30,1999
777,Wild Wild West,222104681,113804681,0.51,108300000,0.49,1999
208,Mission: Impossible II,546388108,215409889,0.39,330978219,0.61,2000
237,Gladiator,503162313,187705427,0.37,315456886,0.63,2000
310,Cast Away,429632142,233632142,0.54,196000000,0.46,2000
386,What Women Want,374111707,182811707,0.49,191300000,0.51,2000
441,Dinosaur,349822765,137748063,0.39,212074702,0.61,2000
452,How the Grinch Stole Christmas,345823032,260715005,0.75,85108027,0.25,2000
477,Meet the Parents,330444045,166244045,0.50,164200000,0.50,2000
480,The Perfect Storm,328718434,182618434,0.56,146100000,0.44,2000
559,X-Men,296339528,157299718,0.53,139039810,0.47,2000
567,What Lies Beneath,291420351,155464351,0.53,135956000,0.47,2000
590,Scary Movie,278019771,157019771,0.57,121000000,0.44,2000
627,Charlie's Angels,264105545,125305545,0.47,138800000,0.53,2000
649,Erin Brockovich,256271286,125595205,0.49,130676081,0.51,2000
676,Unbreakable,248118121,95011339,0.38,153106782,0.62,2000
718,Gone in 60 Seconds,237202299,101648571,0.43,135553728,0.57,2000
769,Chicken Run,224874960,106834564,0.48,118040396,0.53,2000
51,Harry Potter and the Sorcerer's Stone,1024264477,318886962,0.31,705377515,0.69,2001
73,The Lord of the Rings: The Fellowship of the Ring,898523656,316115420,0.35,582408236,0.65,2001
192,Monsters  Inc.,579707738,290642256,0.50,289065482,0.50,2001
248,Shrek,488441368,268163011,0.55,220278357,0.45,2001
287,Ocean's Eleven,450717150,183417150,0.41,267300000,0.59,2001
291,Pearl Harbor,449220945,198542554,0.44,250678391,0.56,2001
295,The Mummy Returns,443280904,202019785,0.46,241261119,0.54,2001
399,Jurassic Park III,368780809,181171875,0.49,187608934,0.51,2001
411,Planet of the Apes,362211740,180011740,0.50,182200000,0.50,2001
422,Spirited Away,357283718,15205725,0.04,342077993,0.96,2001
437,Hannibal,351692268,165092268,0.47,186600000,0.53,2001
448,Rush Hour 2,347325802,226164286,0.65,121161516,0.35,2001
469,Bridget Jones's Diary,334272563,71543427,0.21,262729136,0.79,2001
504,A Beautiful Mind,316791257,170742341,0.54,146048916,0.46,2001
578,American Pie 2,287553595,145103595,0.51,142450000,0.50,2001
598,Lara Croft: Tomb Raider,274703340,131168070,0.48,143535270,0.52,2001
724,A.I. Artificial Intelligence,235926552,78616689,0.33,157309863,0.67,2001
64,The Lord of the Rings: The Two Towers,948893109,342952511,0.36,605940598,0.64,2002
70,Harry Potter and the Chamber of Secrets,926201000,262641637,0.28,663559363,0.72,2002
94,Spider-Man,825025036,407022860,0.49,418002176,0.51,2002
163,Star Wars: Episode II - Attack of the Clones,653779970,310676740,0.48,343103230,0.53,2002
293,Men in Black II,445135288,193735288,0.44,251400000,0.57,2002
308,Die Another Day,431971116,160942139,0.37,271028977,0.63,2002
336,Signs,408247917,227966634,0.56,180281283,0.44,2002
372,Ice Age,383257136,176387405,0.46,206869731,0.54,2002
400,My Big Fat Greek Wedding,368744044,241438208,0.66,127305836,0.35,2002
420,Minority Report,358372926,132072926,0.37,226300000,0.63,2002
435,Catch Me If You Can,352114312,164615351,0.47,187498961,0.53,2002
527,Chicago,306776732,170687518,0.56,136089214,0.44,2002
556,Austin Powers in Goldmember,296938801,213307889,0.72,83630912,0.28,2002
591,xXx,277448382,142109382,0.51,135339000,0.49,2002
594,Scooby-Doo,275678613,153322074,0.56,122356539,0.44,2002
604,Lilo & Stitch,273144151,145794338,0.53,127349813,0.47,2002
673,The Ring,249348933,129128133,0.52,120220800,0.48,2002
701,8 Mile,242875078,116750901,0.48,126124177,0.52,2002
27,The Lord of the Rings: The Return of the King,1155870721,379427292,0.33,776443429,0.67,2003
65,Finding Nemo,941637960,380843261,0.40,560794699,0.60,2003
129,The Matrix Reloaded,741847937,281576461,0.38,460271476,0.62,2003
161,Pirates of the Caribbean: The Curse of the Black Pearl,654264015,305413918,0.47,348850097,0.53,2003
252,Bruce Almighty,484592874,242829261,0.50,241763613,0.50,2003
284,The Last Samurai,454627263,111127263,0.24,343500000,0.76,2003
306,Terminator 3: Rise of the Machines,433371112,150371112,0.35,283000000,0.65,2003
312,The Matrix Revolutions,427344325,139313948,0.33,288030377,0.67,2003
337,X2,407711549,214949694,0.53,192761855,0.47,2003
603,Bad Boys II,273339556,138608444,0.51,134731112,0.49,2003
622,Something's Gotta Give,265328738,124728738,0.47,140600000,0.53,2003
641,Charlie's Angels: Full Throttle,259175788,100830111,0.39,158345677,0.61,2003
647,The Village,256697520,114197520,0.45,142500000,0.56,2003
669,Brother Bear,250397798,85336277,0.34,165061521,0.66,2003
677,Love Actually,247933248,59696144,0.24,188237104,0.76,2003
689,Hulk,245285165,132177234,0.54,113107931,0.46,2003
722,2 Fast 2 Furious,236350661,127154901,0.54,109195760,0.46,2003
734,American Wedding,232722935,104565114,0.45,128157821,0.55,2003
755,Elf,227356156,178053220,0.78,49302936,0.22,2003
782,Scary Movie 3,220673217,110003217,0.50,110670000,0.50,2003
69,Shrek 2,928760770,441226247,0.48,487534523,0.53,2004
101,Harry Potter and the Prisoner of Azkaban,807047946,250105651,0.31,556942295,0.69,2004
108,Spider-Man 2,788976453,373585825,0.47,415390628,0.53,2004
167,The Incredibles,631684650,261441092,0.41,370243558,0.59,2004
179,The Passion of the Christ,612054506,370782930,0.61,241271576,0.39,2004
205,The Day After Tomorrow,552639571,186740799,0.34,365898772,0.66,2004
229,Meet the Fockers,522657936,279261160,0.53,243396776,0.47,2004
239,Troy,497409852,133378256,0.27,364031596,0.73,2004
385,Shark Tale,374583879,160861908,0.43,213721971,0.57,2004
410,Ocean's Twelve,362744280,125544280,0.35,237200000,0.65,2004
429,I  Robot,353133898,144801023,0.41,208332875,0.59,2004
447,National Treasure,347512318,173008894,0.50,174503424,0.50,2004
503,The Polar Express,316897787,189528738,0.60,127369049,0.40,2004
545,Van Helsing,300157638,120177084,0.40,179980554,0.60,2004
569,The Bourne Supremacy,290835269,176241941,0.61,114593328,0.39,2004
623,Bridget Jones: The Edge of Reason,265126918,40226215,0.15,224900703,0.85,2004
716,Howl's Moving Castle,237536126,6789268,0.03,230746858,0.97,2004
776,Fahrenheit 9/11,222446882,119194771,0.54,103252111,0.46,2004
783,Collateral,220239925,101005703,0.46,119234222,0.54,2004
788,The Terminal,219100084,77872883,0.36,141227201,0.65,2004
800,Million Dollar Baby,216763646,100492203,0.46,116271443,0.54,2004
74,Harry Potter and the Goblet of Fire,897048648,290469928,0.32,606578720,0.68,2005
83,Star Wars: Episode III - Revenge of the Sith,868390560,380270577,0.44,488119983,0.56,2005
127,The Chronicles of Narnia: The Lion  the Witch and the Wardrobe,745013115,291710957,0.39,453302158,0.61,2005
184,War of the Worlds,603873119,234280354,0.39,369592765,0.61,2005
201,King Kong,556906378,218080025,0.39,338826353,0.61,2005
214,Madagascar,542063846,193595521,0.36,348468325,0.64,2005
249,Mr. & Mrs. Smith,487287646,186336279,0.38,300951367,0.62,2005
263,Charlie and the Chocolate Factory,474968763,206459076,0.44,268509687,0.57,2005
384,Batman Begins,375298946,206863479,0.55,168435467,0.45,2005
392,Hitch,371594210,179495555,0.48,192098655,0.52,2005
470,Fantastic Four,333535934,154696080,0.46,178839854,0.54,2005
509,Chicken Little,314432837,135386665,0.43,179046172,0.57,2005
575,Wedding Crashers,288485135,209273411,0.73,79211724,0.28,2005
632,Robots,262511490,128200012,0.49,134311478,0.51,2005
742,Constantine,230884728,75976178,0.33,154908550,0.67,2005
772,Flightplan,223387299,89707299,0.40,133680000,0.60,2005
793,Kingdom of Heaven,218122627,47398413,0.22,170724214,0.78,2005
41,Pirates of the Caribbean: Dead Man's Chest,1066179747,423315812,0.40,642863935,0.60,2006
119,The Da Vinci Code,760006945,217536138,0.29,542470807,0.71,2006
155,Ice Age: The Meltdown,667094506,195330621,0.29,471763885,0.71,2006
178,Casino Royale,616505162,167445960,0.27,449059202,0.73,2006
194,Night at the Museum,574481229,250863268,0.44,323617961,0.56,2006
277,Cars,461991867,244082982,0.53,217908885,0.47,2006
279,X-Men: The Last Stand,460435291,234362462,0.51,226072829,0.49,2006
350,Mission: Impossible III,398479497,134029801,0.34,264449696,0.66,2006
357,Superman Returns,391081192,200081192,0.51,191000000,0.49,2006
367,Happy Feet,384336108,198000317,0.52,186335791,0.49,2006
459,Over the Hedge,339795890,155019340,0.46,184776550,0.54,2006
485,The Devil Wears Prada,326706115,124740460,0.38,201965655,0.62,2006
524,The Pursuit of Happyness,307127625,163566459,0.53,143561166,0.47,2006
566,The Departed,291480452,132399394,0.45,159081058,0.55,2006
631,Borat,262552893,128505958,0.49,134046935,0.51,2006
668,Eragon,250425512,75030163,0.30,175395349,0.70,2006
707,Click,240685326,137355633,0.57,103329693,0.43,2006
60,Pirates of the Caribbean: At World's End,961691209,309420425,0.32,652270784,0.68,2007
67,Harry Potter and the Order of the Phoenix,939288806,292382727,0.31,646906079,0.69,2007
75,Spider-Man 3,894983373,336530303,0.38,558453070,0.62,2007
100,Shrek the Third,813367380,322719944,0.40,490647436,0.60,2007
138,Transformers,709709780,319246193,0.45,390463587,0.55,2007
173,Ratatouille,623726085,206445654,0.33,417280431,0.67,2007
191,I Am Legend,585410052,256393010,0.44,329017042,0.56,2007
218,The Simpsons Movie,536414293,183135014,0.34,353279279,0.66,2007
281,National Treasure: Book of Secrets,459242249,219964115,0.48,239278134,0.52,2007
283,300,456082343,210629101,0.46,245453242,0.54,2007
294,The Bourne Ultimatum,444100035,227471070,0.51,216628965,0.49,2007
361,Live Free or Die Hard,388156011,134529403,0.35,253626608,0.65,2007
390,The Golden Compass,372234864,70107728,0.19,302127136,0.81,2007
405,Alvin and the Chipmunks,365352546,217326974,0.60,148025572,0.41,2007
458,Enchanted,340487862,127807262,0.38,212680600,0.63,2007
516,Ocean's Thirteen,311312624,117154724,0.38,194157900,0.62,2007
539,Fantastic Four: Rise of the Silver Surfer,301913131,131921738,0.44,169991393,0.56,2007
563,Bee Movie,293514336,126631277,0.43,166883059,0.57,2007
613,American Gangster,269755430,130164645,0.48,139590785,0.52,2007
642,Rush Hour 3,258097122,140125968,0.54,117971154,0.46,2007
658,Wild Hogs,253625427,168273550,0.66,85351877,0.34,2007
736,Juno,232372681,143495265,0.62,88877416,0.38,2007
738,Mr. Bean's Holiday,232225908,33302167,0.14,198923741,0.86,2007
748,Ghost Rider,228738393,115802596,0.51,112935797,0.49,2007
785,Knocked Up,219922417,148768917,0.68,71153500,0.32,2007
47,The Dark Knight,1029266147,534987076,0.52,494279071,0.48,2008
107,Indiana Jones and the Kingdom of the Crystal Skull,790653942,317101119,0.40,473552823,0.60,2008
146,Mamma Mia!,694479834,144169664,0.21,550310170,0.79,2008
166,Kung Fu Panda,632083197,215771591,0.34,416311606,0.66,2008
169,Hancock,629443428,227946274,0.36,401497154,0.64,2008
183,Madagascar: Escape 2 Africa,603900354,180010950,0.30,423889404,0.70,2008
186,Quantum of Solace,589580482,168368427,0.29,421212055,0.71,2008
190,Iron Man,585796247,319034126,0.55,266762121,0.46,2008
230,WALL·E,521311890,223808164,0.43,297503726,0.57,2008
319,The Chronicles of Narnia: Prince Caspian,419665568,141621490,0.34,278044078,0.66,2008
320,Sex and the City,418765519,152647258,0.36,266118261,0.64,2008
334,Twilight,408430415,193962473,0.48,214467942,0.53,2008
343,The Mummy: Tomb of the Dragon Emperor,403449830,102491776,0.25,300958054,0.75,2008
380,Slumdog Millionaire,378410542,141319928,0.37,237090614,0.63,2008
455,Wanted,342463063,134508551,0.39,207954512,0.61,2008
463,The Curious Case of Benjamin Button,335802786,127509326,0.38,208293460,0.62,2008
518,Bolt,309979994,114053579,0.37,195926415,0.63,2008
551,Horton Hears a Who!,298572799,154529439,0.52,144043360,0.48,2008
611,Gran Torino,269958228,148095302,0.55,121862926,0.45,2008
612,10 000 BC,269784201,94784201,0.35,175000000,0.65,2008
624,The Incredible Hulk,264770996,134806913,0.51,129964083,0.49,2008
633,Knight and Day,261989769,76423035,0.29,185566734,0.71,2008
653,Marley & Me,255743093,143153751,0.56,112589342,0.44,2008
659,High School Musical 3: Senior Year,252909177,90559416,0.36,162349761,0.64,2008
691,Welcome to the Sticks,245144417,-,-,245144417,1.00,2008
696,Journey to the Center of the Earth,244232688,101704370,0.42,142528318,0.58,2008
733,The Day the Earth Stood Still,233093859,79366978,0.34,153726881,0.66,2008
743,Get Smart,230685453,130319208,0.57,100366245,0.44,2008
759,Taken,226837760,145000989,0.64,81836771,0.36,2008
767,Jumper,225132113,80172128,0.36,144959985,0.64,2008
773,Yes Man,223241637,97690976,0.44,125550661,0.56,2008
786,What Happens in Vegas,219375562,80277646,0.37,139097916,0.63,2008
1,Avatar,2923706026,785221649,0.27,2138484377,0.73,2009
68,Harry Potter and the Half-Blood Prince,934770304,302334374,0.32,632435930,0.68,2009
77,Ice Age: Dawn of the Dinosaurs,886686817,196573705,0.22,690113112,0.78,2009
93,Transformers: Revenge of the Fallen,836303693,402111870,0.48,434191823,0.52,2009
106,2012,791217826,166112167,0.21,625105659,0.79,2009
130,Up,735099102,293004164,0.40,442094938,0.60,2009
136,The Twilight Saga: New Moon,711025481,297816253,0.42,413209228,0.58,2009
228,Sherlock Holmes,524028679,209028679,0.40,315000000,0.60,2009
250,Angels & Demons,485930816,133375846,0.27,352554970,0.73,2009
270,The Hangover,469328079,277339746,0.59,191988333,0.41,2009
296,Alvin and the Chipmunks: The Squeakquel,443140005,219614612,0.50,223525393,0.50,2009
327,Night at the Museum: Battle of the Smithsonian,413106170,177243721,0.43,235862449,0.57,2009
365,Star Trek,385680446,257730019,0.67,127950427,0.33,2009
375,Monsters vs. Aliens,381509870,198351526,0.52,183158344,0.48,2009
389,X-Men Origins: Wolverine,373062864,179883157,0.48,193179707,0.52,2009
393,Terminator Salvation,371353001,125322469,0.34,246030532,0.66,2009
415,Fast & Furious,360366870,155064265,0.43,205302605,0.57,2009
462,Prince of Persia: The Sands of Time,336365676,90759676,0.27,245606000,0.73,2009
488,A Christmas Carol,325286646,137855863,0.42,187430783,0.58,2009
496,Inglourious Basterds,321457747,120540719,0.38,200917028,0.63,2009
502,The Proposal,317375031,163958031,0.52,153417000,0.48,2009
521,The Blind Side,309231694,255982860,0.83,53248834,0.17,2009
537,G.I. Joe: The Rise of Cobra,302469017,150201498,0.50,152267519,0.50,2009
565,G-Force,292817898,119436770,0.41,173381128,0.59,2009
619,The Princess and the Frog,267045765,104400899,0.39,162644866,0.61,2009
635,This Is It,261183588,72091016,0.28,189092572,0.72,2009
700,Cloudy with a Chance of Meatballs,243006126,124870275,0.51,118135851,0.49,2009
787,It's Complicated,219103655,112735375,0.51,106368280,0.49,2009
40,Toy Story 3,1067316101,415004880,0.39,652311221,0.61,2010
50,Alice in Wonderland,1025468216,334191110,0.33,691277106,0.67,2010
55,Harry Potter and the Deathly Hallows: Part 1,972584232,296374621,0.31,676209611,0.70,2010
92,Inception,839030630,292587330,0.35,546443300,0.65,2010
123,Shrek Forever After,752600867,238736787,0.32,513864080,0.68,2010
143,The Twilight Saga: Eclipse,698509825,300531751,0.43,397978074,0.57,2010
172,Iron Man 2,623933331,312433331,0.50,311500000,0.50,2010
185,Tangled,592462816,200821936,0.34,391640880,0.66,2010
212,Despicable Me,543157985,251557985,0.46,291600000,0.54,2010
242,How to Train Your Dragon,494879471,217581231,0.44,277298240,0.56,2010
245,Clash of the Titans,493214993,163214888,0.33,330000105,0.67,2010
253,The King's Speech,484068861,138797449,0.29,345271412,0.71,2010
323,The Chronicles of Narnia: The Voyage of the Dawn Treader,415686217,104386950,0.25,311299267,0.75,2010
349,TRON: Legacy,400063852,172062763,0.43,228001089,0.57,2010
417,The Karate Kid,359126022,176591618,0.49,182534404,0.51,2010
479,Black Swan,329398046,106954678,0.33,222443368,0.68,2010
492,Megamind,321885765,148415853,0.46,173469912,0.54,2010
495,Robin Hood,321669741,105269730,0.33,216400011,0.67,2010
501,The Last Airbender,319713881,131772187,0.41,187941694,0.59,2010
517,Little Fockers,310650585,148438600,0.48,162211985,0.52,2010
544,Resident Evil: Afterlife,300228084,60128566,0.20,240099518,0.80,2010
561,Shutter Island,294805697,128012934,0.43,166792763,0.57,2010
564,Salt,293503354,118311368,0.40,175191986,0.60,2010
570,Sex and the City 2,290745055,95347692,0.33,195397363,0.67,2010
588,The Tourist,278780441,67631157,0.24,211149284,0.76,2010
599,The Expendables,274470394,103068524,0.38,171401870,0.62,2010
606,Grown Ups,271457301,162001186,0.60,109456115,0.40,2010
662,True Grit,252276927,171243005,0.68,81033922,0.32,2010
717,Gulliver's Travels,237382724,42779261,0.18,194603463,0.82,2010
760,Percy Jackson & the Olympians: The Lightning Thief,226497209,88768303,0.39,137728906,0.61,2010
768,The Social Network,224920375,96962694,0.43,127957681,0.57,2010
18,Harry Potter and the Deathly Hallows: Part 2,1342360114,381447587,0.28,960912527,0.72,2011
33,Transformers: Dark of the Moon,1123794079,352390543,0.31,771403536,0.69,2011
44,Pirates of the Caribbean: On Stranger Tides,1046721266,241071802,0.23,805649464,0.77,2011
135,The Twilight Saga: Breaking Dawn - Part 1,712205856,281287133,0.40,430918723,0.61,2011
145,Mission: Impossible - Ghost Protocol,694713380,209397903,0.30,485315477,0.70,2011
156,Kung Fu Panda 2,665692281,165249063,0.25,500443218,0.75,2011
171,Fast Five,626137675,209837675,0.34,416300000,0.67,2011
189,The Hangover Part II,586764305,254464305,0.43,332300000,0.57,2011
199,The Smurfs,563749323,142614158,0.25,421135165,0.75,2011
200,Cars 2,559852396,191452396,0.34,368400000,0.66,2011
202,Puss in Boots,554987477,149260504,0.27,405726973,0.73,2011
211,Sherlock Holmes: A Game of Shadows,543848418,186848418,0.34,357000000,0.66,2011
254,Rio,483866772,143619809,0.30,340246963,0.70,2011
256,Rise of the Planet of the Apes,481800873,176760185,0.37,305040688,0.63,2011
290,Thor,449326618,181030624,0.40,268295994,0.60,2011
313,The Intouchables,426588510,10198820,0.02,416389690,0.98,2011
387,The Adventures of Tintin,373993951,77591831,0.21,296402120,0.79,2011
394,Captain America: The First Avenger,370569774,176654505,0.48,193915269,0.52,2011
432,X-Men: First Class,352616690,146408305,0.42,206208385,0.59,2011
454,Alvin and the Chipmunks: Chipwrecked,342695435,133110742,0.39,209584693,0.61,2011
529,Bridesmaids,306442085,169106725,0.55,137335360,0.45,2011
550,Real Steel,299268508,85468508,0.29,213800000,0.71,2011
638,Super 8,260095986,127004179,0.49,133091807,0.51,2011
684,Rango,245724603,123477607,0.50,122246996,0.50,2011
719,Green Lantern,237201172,116601172,0.49,120600000,0.51,2011
735,The Girl with the Dragon Tattoo,232617430,102515793,0.44,130101637,0.56,2011
753,The Green Hornet,227817248,98780042,0.43,129037206,0.57,2011
758,Immortals,226904017,83504017,0.37,143400000,0.63,2011
10,The Avengers,1520538536,623357910,0.41,897180626,0.59,2012
30,Skyfall,1142471295,304360277,0.27,838111018,0.73,2012
36,The Dark Knight Rises,1085067637,448149584,0.41,636918053,0.59,2012
52,The Hobbit: An Unexpected Journey,1017030651,303030651,0.30,714000000,0.70,2012
80,Ice Age: Continental Drift,877244782,161321843,0.18,715922939,0.82,2012
90,The Twilight Saga: Breaking Dawn - Part 2,848593948,292324737,0.34,556269211,0.66,2012
121,The Amazing Spider-Man,757930663,262030663,0.35,495900000,0.65,2012
125,Madagascar 3: Europe's Most Wanted,746921274,216391482,0.29,530529792,0.71,2012
144,The Hunger Games,695220619,408010692,0.59,287209927,0.41,2012
162,Men in Black 3,654213485,179020854,0.27,475192631,0.73,2012
180,Life of Pi,609016565,124987023,0.21,484029542,0.80,2012
206,Ted,549368315,218815487,0.40,330552828,0.60,2012
216,Brave,538983207,237283207,0.44,301700000,0.56,2012
268,Wreck-It Ralph,471222889,189422889,0.40,281800000,0.60,2012
297,Les Misérables,442299309,148809770,0.34,293489539,0.66,2012
315,Django Unchained,426074373,162805434,0.38,263268939,0.62,2012
344,Prometheus,403354469,126477084,0.31,276877385,0.69,2012
351,Snow White and the Huntsman,396592829,155332381,0.39,241260448,0.61,2012
382,Taken 2,376152455,139854287,0.37,236298168,0.63,2012
419,Hotel Transylvania,358375603,148313048,0.41,210062555,0.59,2012
444,The Lorax,349183316,214373500,0.61,134809816,0.39,2012
464,Journey 2: The Mysterious Island,335287748,103887748,0.31,231400000,0.69,2012
508,The Expendables 2,314975955,85028192,0.27,229947763,0.73,2012
525,Rise of the Guardians,306941670,103412758,0.34,203528912,0.66,2012
535,Battleship,303025485,65422625,0.22,237602860,0.78,2012
538,Wrath of the Titans,301970083,83670083,0.28,218300000,0.72,2012
584,John Carter,284139100,73078100,0.26,211061000,0.74,2012
592,The Bourne Legacy,276144750,113203870,0.41,162940880,0.59,2012
595,Lincoln,275293450,182207973,0.66,93085477,0.34,2012
610,We're the Millers,269994119,150394119,0.56,119600000,0.44,2012
688,Dark Shadows,245527149,79727149,0.33,165800000,0.68,2012
710,Resident Evil: Retribution,240159255,42345531,0.18,197813724,0.82,2012
721,Silver Linings Playbook,236412453,132092958,0.56,104319495,0.44,2012
728,American Reunion,234989584,57011521,0.24,177978063,0.76,2012
737,Argo,232325503,136025503,0.59,96300000,0.41,2012
792,Jack Reacher,218340595,80070736,0.37,138269859,0.63,2012
20,Frozen,1334291571,400953009,0.30,933338562,0.70,2013
25,Iron Man 3,1215577205,409013994,0.34,806563211,0.66,2013
56,Despicable Me 2,970766005,368065385,0.38,602700620,0.62,2013
61,The Hobbit: The Desolation of Smaug,959027992,258387334,0.27,700640658,0.73,2013
84,The Hunger Games: Catching Fire,865011746,424668047,0.49,440343699,0.51,2013
109,Fast & Furious 6,788680968,238679850,0.30,550001118,0.70,2013
115,Gravity,773031583,274092705,0.36,498938878,0.65,2013
128,Monsters University,743559645,268492764,0.36,475066881,0.64,2013
154,Man of Steel,670145518,291045518,0.43,379100000,0.57,2013
164,Thor: The Dark World,644783140,206362140,0.32,438421000,0.68,2013
188,The Croods,587235983,187168425,0.32,400067558,0.68,2013
215,World War Z,540455876,202807711,0.38,337648165,0.63,2013
244,Oz the Great and Powerful,493311825,234911825,0.48,258400000,0.52,2013
274,Star Trek Into Darkness,467365246,228778661,0.49,238586585,0.51,2013
325,The Wolverine,414828246,132556852,0.32,282271394,0.68,2013
330,Pacific Rim,411002906,101802906,0.25,309200000,0.75,2013
340,The Wolf of Wall Street,406878233,116900694,0.29,289977539,0.71,2013
383,G.I. Joe: Retaliation,375740705,122523060,0.33,253217645,0.67,2013
412,The Hangover Part III,362000072,112200072,0.31,249800000,0.69,2013
427,The Great Gatsby,353659851,144857996,0.41,208801855,0.59,2013
436,Now You See Me,351723989,117723989,0.34,234000000,0.67,2013
446,The Smurfs 2,347545360,71017784,0.20,276527576,0.80,2013
498,The Conjuring,320406242,137446368,0.43,182959874,0.57,2013
531,A Good Day to Die Hard,304654182,67349198,0.22,237304984,0.78,2013
581,Oblivion,286168572,89107235,0.31,197061337,0.69,2013
582,Elysium,286140700,93050117,0.33,193090583,0.68,2013
586,Turbo,282570682,83028128,0.29,199542554,0.71,2013
600,Cloudy with a Chance of Meatballs 2,274325949,119793567,0.44,154532382,0.56,2013
614,Epic,268426634,107518682,0.40,160907952,0.60,2013
637,The Lone Ranger,260502115,89302115,0.34,171200000,0.66,2013
665,American Hustle,251171807,150117807,0.60,101054000,0.40,2013
682,Grown Ups 2,246984278,133668525,0.54,113315753,0.46,2013
698,After Earth,243611982,60522097,0.25,183089885,0.75,2013
709,Planes,240171783,90288712,0.38,149883071,0.62,2013
746,The Heat,229930771,159582188,0.69,70348583,0.31,2013
762,Hansel & Gretel: Witch Hunters,226349749,55703475,0.25,170646274,0.75,2013
790,Captain Phillips,218791811,107100855,0.49,111690956,0.51,2013
35,Transformers: Age of Extinction,1104054072,245439076,0.22,858614996,0.78,2014
59,The Hobbit: The Battle of the Five Armies,962201338,255138261,0.27,707063077,0.74,2014
114,Guardians of the Galaxy,773350147,333718600,0.43,439631547,0.57,2014
120,Maleficent,759853685,241410378,0.32,518443307,0.68,2014
122,The Hunger Games: Mockingjay - Part 1,755357103,337135885,0.45,418221218,0.55,2014
126,X-Men: Days of Future Past,746045700,233921534,0.31,512124166,0.69,2014
131,Interstellar,729059232,188020017,0.26,541039215,0.74,2014
134,Captain America: The Winter Soldier,714421503,259766572,0.36,454654931,0.64,2014
137,Dawn of the Planet of the Apes,710644566,208545589,0.29,502098977,0.71,2014
139,The Amazing Spider-Man 2,708982323,202853933,0.29,506128390,0.71,2014
159,Big Hero 6,657869686,222527828,0.34,435341858,0.66,2014
175,How to Train Your Dragon 2,621537519,177002924,0.29,444534595,0.72,2014
207,American Sniper,547659020,350159020,0.64,197500000,0.36,2014
226,Godzilla,524976069,200676069,0.38,324300000,0.62,2014
238,Rio 2,498781117,131538435,0.26,367242682,0.74,2014
251,Teenage Mutant Ninja Turtles,485004754,191204754,0.39,293800000,0.61,2014
271,Lucy,469058574,126663600,0.27,342394974,0.73,2014
272,The Lego Movie,468266122,257966122,0.55,210300000,0.45,2014
388,Penguins of Madagascar,373515621,83850911,0.22,289664710,0.78,2014
395,Edge of Tomorrow,370541256,100206256,0.27,270335000,0.73,2014
397,Gone Girl,369330363,167767189,0.45,201563174,0.55,2014
409,Night at the Museum: Secret of the Tomb,363204635,113746621,0.31,249458014,0.69,2014
416,Noah,359200044,101200044,0.28,258000000,0.72,2014
445,The Maze Runner,348319861,102427862,0.29,245891999,0.71,2014
460,300: Rise of an Empire,337580051,106580051,0.32,231000000,0.68,2014
476,22 Jump Street,331333876,191719337,0.58,139614539,0.42,2014
523,The Fault in Our Stars,307166834,124872350,0.41,182294484,0.59,2014
572,Divergent,288885818,150947895,0.52,137937923,0.48,2014
587,Paddington,282438834,76271832,0.27,206167002,0.73,2014
593,Mr. Peabody & Sherman,275698039,111506430,0.40,164191609,0.60,2014
607,Neighbors,270665134,150157400,0.56,120507734,0.45,2014
615,Exodus: Gods and Kings,268175631,65014513,0.24,203161118,0.76,2014
645,Annabelle,257589721,84284252,0.33,173305469,0.67,2014
694,Hercules,244819862,72688614,0.30,172131248,0.70,2014
703,RoboCop,242688965,58607007,0.24,184081958,0.76,2014
731,The Imitation Game,233555708,91125683,0.39,142430025,0.61,2014
774,Non-Stop,222809600,92168600,0.41,130641000,0.59,2014
798,Dracula Untold,217124280,56280355,0.26,160843925,0.74,2014
5,Star Wars: Episode VII - The Force Awakens,2071310218,936662225,0.45,1134647993,0.55,2015
8,Jurassic World,1671537444,653406625,0.39,1018130819,0.61,2015
11,Furious 7,1515341399,353007020,0.23,1162334379,0.77,2015
15,Avengers: Age of Ultron,1405018048,459005868,0.33,946012180,0.67,2015
26,Minions,1159444662,336045770,0.29,823398892,0.71,2015
78,Spectre,880705312,200074609,0.23,680630703,0.77,2015
87,Inside Out,858848019,356921711,0.42,501926308,0.58,2015
150,Mission: Impossible - Rogue Nation,682716636,195042377,0.29,487674259,0.71,2015
157,The Hunger Games: Mockingjay - Part 2,661456563,281723902,0.43,379732661,0.57,2015
168,The Martian,630620818,228433663,0.36,402187155,0.64,2015
195,Fifty Shades of Grey,569651467,166167230,0.29,403484237,0.71,2015
213,Cinderella,542358331,201151353,0.37,341206978,0.63,2015
219,The Revenant,532950503,183637894,0.35,349312609,0.66,2015
233,Ant-Man,519311965,180202163,0.35,339109802,0.65,2015
261,Hotel Transylvania 2,475186706,169700110,0.36,305486596,0.64,2015
264,San Andreas,474609154,155190832,0.33,319418322,0.67,2015
300,Terminator Genisys,440603537,89760956,0.20,350842581,0.80,2015
326,Kingsman: The Secret Service,414351546,128261724,0.31,286089822,0.69,2015
363,Monster Hunt,387053506,32766,<0.1%,387020740,1.00,2015
364,Home,386041607,177397510,0.46,208644097,0.54,2015
376,Mad Max: Fury Road,380418444,154280290,0.41,226138154,0.59,2015
474,The Good Dinosaur,332207671,123087120,0.37,209120551,0.63,2015
486,Taken 3,326479141,89256424,0.27,237222717,0.73,2015
489,The SpongeBob Movie: Sponge Out of Water,325186032,162994032,0.50,162192000,0.50,2015
514,Maze Runner: The Scorch Trials,312296056,81697192,0.26,230598864,0.74,2015
554,The Divergent Series: Insurgent,297002527,130179072,0.44,166823455,0.56,2015
579,Pitch Perfect 2,287144079,184296230,0.64,102847849,0.36,2015
640,Mojin: The Lost Legend,259368448,1243810,0.01,258124638,1.00,2015
648,Lost in Hong Kong,256283912,1302281,0.01,254981631,1.00,2015
683,The Peanuts Movie,246233113,130178411,0.53,116054702,0.47,2015
693,Pixels,244874809,78747585,0.32,166127224,0.68,2015
702,Daddy's Home,242786137,150357137,0.62,92429000,0.38,2015
726,Spy,235666219,110825712,0.47,124840507,0.53,2015
730,Alvin and the Chipmunks: The Road Chip,234798636,85886987,0.37,148911649,0.63,2015
749,Goodbye Mr. Loser,228122928,1293626,0.01,226829302,0.99,2015
28,Captain America: Civil War,1155046416,408084349,0.35,746962067,0.65,2016
42,Rogue One: A Star Wars Story,1058682142,533539991,0.50,525142151,0.50,2016
46,Finding Dory,1029266989,486295561,0.47,542971428,0.53,2016
49,Zootopia,1025521689,341268248,0.33,684253441,0.67,2016
58,The Jungle Book,967724775,364001123,0.38,603723652,0.62,2016
76,The Secret Life of Pets,894328469,368384330,0.41,525944139,0.59,2016
81,Batman v Superman: Dawn of Justice,874362803,330360194,0.38,544002609,0.62,2016
98,Fantastic Beasts and Where to Find Them,816037575,234037575,0.29,582000000,0.71,2016
111,Deadpool,782836791,363070709,0.46,419766082,0.54,2016
124,Suicide Squad,749200054,325100054,0.43,424100000,0.57,2016
148,Moana,687228908,248757044,0.36,438471864,0.64,2016
152,Doctor Strange,677796076,232641920,0.34,445154156,0.66,2016
165,Sing,634338384,270578425,0.43,363759959,0.57,2016
203,The Mermaid,553810228,3232685,0.01,550577543,0.99,2016
210,X-Men: Apocalypse,543934105,155442489,0.29,388491616,0.71,2016
231,Kung Fu Panda 3,521170825,143528619,0.28,377642206,0.73,2016
267,La La Land,471989295,151101803,0.32,320887492,0.68,2016
302,Warcraft,439048914,47365290,0.11,391683624,0.89,2016
324,Jason Bourne,415484914,162434410,0.39,253050504,0.61,2016
333,Ice Age: Collision Course,408754975,64063008,0.16,344691967,0.84,2016
360,Independence Day: Resurgence,389681935,103144286,0.27,286537649,0.74,2016
373,Your Name.,382238181,5017246,0.01,377220935,0.99,2016
423,The Legend of Tarzan,357243061,126643061,0.35,230600000,0.65,2016
433,The Angry Birds Movie,352333929,107509366,0.31,244824563,0.70,2016
449,Trolls,347188778,154025064,0.44,193163714,0.56,2016
453,Star Trek Beyond,343471816,158848340,0.46,184623476,0.54,2016
466,The Great Wall,334933831,45540830,0.14,289393001,0.86,2016
467,Now You See Me 2,334897606,65075540,0.19,269822066,0.81,2016
490,The Conjuring 2,322811541,102516140,0.32,220295401,0.68,2016
515,Resident Evil: The Final Chapter,312242626,26830068,0.09,285412558,0.91,2016
533,Dangal,303723636,12391761,0.04,291331875,0.96,2016
534,Passengers,303144152,100014699,0.33,203129453,0.67,2016
548,Alice Through the Looking Glass,299820798,77041381,0.26,222779417,0.74,2016
558,Miss Peregrine's Home for Peculiar Children,296482446,87242834,0.29,209239612,0.71,2016
652,Get Out,255745157,176196665,0.69,79548492,0.31,2016
687,Teenage Mutant Ninja Turtles: Out of the Shadows,245623848,82051601,0.33,163572247,0.67,2016
697,Sully,243870033,125070033,0.51,118800000,0.49,2016
706,Assassin's Creed,240697856,54647948,0.23,186049908,0.77,2016
723,Hidden Figures,235956898,169607287,0.72,66349611,0.28,2016
747,Ghostbusters,229147509,128350574,0.56,100796935,0.44,2016
784,Inferno,220021259,34343574,0.16,185677685,0.84,2016
799,Central Intelligence,216940871,127440871,0.59,89500000,0.41,2016
19,Star Wars: Episode VIII - The Last Jedi,1334407706,620181382,0.47,714226324,0.54,2017
22,Beauty and the Beast,1266115964,504481165,0.40,761634799,0.60,2017
24,The Fate of the Furious,1236005118,226008385,0.18,1009996733,0.82,2017
45,Despicable Me 3,1034800131,264624300,0.26,770175831,0.74,2017
54,Jumanji: Welcome to the Jungle,995339117,404540171,0.41,590798946,0.59,2017
79,Spider-Man: Homecoming,880166924,334201140,0.38,545965784,0.62,2017
82,Wolf Warrior 2,870325439,2721100,0.00,867604339,1.00,2017
85,Guardians of the Galaxy Vol. 2,863756051,389813101,0.45,473942950,0.55,2017
89,Thor: Ragnarok,855301806,315058289,0.37,540243517,0.63,2017
95,Wonder Woman,823970682,412845172,0.50,411125510,0.50,2017
99,Coco,814337054,210460015,0.26,603877039,0.74,2017
103,Pirates of the Caribbean: Dead Men Tell No Tales,795922298,172558876,0.22,623363422,0.78,2017
141,It,704242551,328874981,0.47,375367570,0.53,2017
158,Justice League,661326987,229024295,0.35,432302692,0.65,2017
176,Logan,619179950,226277068,0.37,392902882,0.64,2017
182,Transformers: The Last Knight,605425157,130168683,0.22,475256474,0.79,2017
197,Kong: Skull Island,568652812,168052812,0.30,400600000,0.70,2017
223,The Boss Baby,527965936,175003033,0.33,352962903,0.67,2017
224,Dunkirk,527816307,189740665,0.36,338075642,0.64,2017
247,War for the Planet of the Apes,490719763,146880162,0.30,343839601,0.70,2017
304,The Greatest Showman,438550306,174340174,0.40,264210132,0.60,2017
331,Kingsman: The Golden Circle,410902662,100234838,0.24,310667824,0.76,2017
332,The Mummy,409231607,80227895,0.20,329003712,0.80,2017
370,Cars 3,383930656,152901115,0.40,231029541,0.60,2017
374,Fifty Shades Darker,381545846,114581250,0.30,266964596,0.70,2017
431,Murder on the Orient Express,352794081,102826543,0.29,249967538,0.71,2017
450,xXx: Return of Xander Cage,346118277,44898413,0.13,301219864,0.87,2017
468,Never Say Die,334530869,-,-,334530869,1.00,2017
507,Wonder,315025930,132422809,0.42,182603121,0.58,2017
513,The Lego Batman Movie,312336671,175936671,0.56,136400000,0.44,2017
522,The Ex-File 3: Return of the Exes,307592427,838959,0.00,306753468,1.00,2017
528,Annabelle: Creation,306592201,102092201,0.33,204500000,0.67,2017
560,Ferdinand,296069199,84410380,0.29,211658819,0.72,2017
589,Split,278454417,138291365,0.50,140163052,0.50,2017
617,Blade Runner 2049,267685209,92071675,0.34,175613534,0.66,2017
644,Kung Fu Yoga,257753889,362657,0.00,257391232,1.00,2017
655,Baahubali 2: The Conclusion,254158390,20186659,0.08,233971731,0.92,2017
679,Journey to the West: The Demons Strike Back,247585244,880346,0.00,246704898,1.00,2017
705,Alien: Covenant,240891763,74262031,0.31,166629732,0.69,2017
750,Paddington 2,227994792,40907738,0.18,187087054,0.82,2017
756,Youth,227091290,1891956,0.01,225199334,0.99,2017
757,Baby Driver,226945087,107825862,0.48,119119225,0.53,2017
763,Valerian and the City of a Thousand Planets,225973340,41189488,0.18,184783852,0.82,2017
778,Geostorm,221900160,33700160,0.15,188200000,0.85,2017
795,The Emoji Movie,217776646,86089513,0.40,131687133,0.61,2017
6,Avengers: Infinity War,2052415039,678815482,0.33,1373599557,0.67,2018
17,Black Panther,1349926083,700426566,0.52,649499517,0.48,2018
21,Jurassic World: Fallen Kingdom,1310466296,417719760,0.32,892746536,0.68,2018
23,Incredibles 2,1243225667,608581744,0.49,634643923,0.51,2018
29,Aquaman,1152028393,335104314,0.29,816924079,0.71,2018
71,Bohemian Rhapsody,910809311,216668042,0.24,694141269,0.76,2018
88,Venom,856085151,213515506,0.25,642569645,0.75,2018
105,Mission: Impossible - Fallout,791657398,220159104,0.28,571498294,0.72,2018
110,Deadpool 2,785896609,324591735,0.41,461304874,0.59,2018
160,Fantastic Beasts: The Crimes of Grindelwald,655755901,159555901,0.24,496200000,0.76,2018
174,Ant-Man and the Wasp,622674139,216648740,0.35,406025399,0.65,2018
181,Ready Player One,607874134,137715350,0.23,470158784,0.77,2018
193,Operation Red Sea,579330426,1543547,0.00,577786879,1.00,2018
209,Detective Chinatown 2,544185156,1983984,0.00,542201172,1.00,2018
220,The Meg,529338515,145522784,0.28,383815731,0.73,2018
221,Ralph Breaks the Internet,529323962,201091711,0.38,328232251,0.62,2018
222,Hotel Transylvania 3: Summer Vacation,528583774,167510016,0.32,361073758,0.68,2018
225,The Grinch,526760632,271384731,0.52,255375901,0.49,2018
273,Bumblebee,467989645,127195589,0.27,340794056,0.73,2018
286,Dying to Survive,451183391,6752,-,451176639,1.00,2018
305,A Star Is Born,436433122,215333122,0.49,221100000,0.51,2018
311,Rampage,428128233,101028233,0.24,327100000,0.76,2018
346,Mamma Mia! Here We Go Again,402264843,120634935,0.30,281629908,0.70,2018
356,Solo: A Star Wars Story,392924807,213767512,0.54,179157295,0.46,2018
368,Spider-Man: Into the Spider-Verse,384298736,190241310,0.50,194057426,0.51,2018
391,Fifty Shades Freed,371985018,100407760,0.27,271577258,0.73,2018
402,Hello Mr. Billionaire,366961907,-,-,366961907,1.00,2018
404,The Nun,366082797,117481222,0.32,248601575,0.68,2018
414,Monster Hunt 2,361682618,706153,0.00,360976465,1.00,2018
439,Peter Rabbit,351496066,115253424,0.33,236242642,0.67,2018
442,Mary Poppins Returns,349546142,171958438,0.49,177587704,0.51,2018
457,A Quiet Place,340952971,188024361,0.55,152928610,0.45,2018
493,Green Book,321752656,85080171,0.26,236672485,0.74,2018
530,Skyscraper,304868961,68420120,0.22,236448841,0.78,2018
552,Ocean's Eight,297795726,140295726,0.47,157500000,0.53,2018
568,Pacific Rim: Uprising,290930148,59874525,0.21,231055623,0.79,2018
576,Maze Runner: The Death Cure,288175335,58032443,0.20,230142892,0.80,2018
597,Tomb Raider,274950803,58250803,0.21,216700000,0.79,2018
639,Halloween,259939835,159342015,0.61,100597820,0.39,2018
713,Crazy Rich Asians,239343729,174837452,0.73,64506277,0.27,2018
794,Smallfoot,218015531,83315531,0.38,134700000,0.62,2018
2,Avengers: Endgame,2799439100,858373000,0.31,1941066100,0.69,2019
9,The Lion King,1663075401,543638043,0.33,1119437358,0.67,2019
13,Frozen II,1453683476,477373578,0.33,976309898,0.67,2019
31,Spider-Man: Far from Home,1131927996,390532085,0.35,741395911,0.66,2019
32,Captain Marvel,1131416446,426829839,0.38,704586607,0.62,2019
37,Joker,1078958282,335477657,0.31,743480625,0.69,2019
38,Star Wars: Episode IX - The Rise of Skywalker,1077022372,515202542,0.48,561819830,0.52,2019
39,Toy Story 4,1073841394,434038008,0.40,639803386,0.60,2019
43,Aladdin,1054304000,355559216,0.34,698744784,0.66,2019
102,Jumanji: The Next Level,801693929,320314960,0.40,481378969,0.60,2019
118,Fast & Furious Presents: Hobbs & Shaw,760732926,173956935,0.23,586775991,0.77,2019
132,Ne Zha,726264074,3695533,0.01,722568541,1.00,2019
142,The Wandering Earth,699992512,5971413,0.01,694021099,0.99,2019
227,How to Train Your Dragon: The Hidden World,524580592,160945505,0.31,363635087,0.69,2019
246,Maleficent: Mistress of Evil,491730089,113929605,0.23,377800484,0.77,2019
266,It Chapter Two,473122525,211622525,0.45,261500000,0.55,2019
288,My People  My Country,450064993,2356683,0.01,447708310,1.00,2019
289,Pokémon: Detective Pikachu,450062638,144174568,0.32,305888070,0.68,2019
309,The Secret Life of Pets 2,431058604,158874395,0.37,272184209,0.63,2019
321,The Captain,417282021,706572,0.00,416575449,1.00,2019
342,Alita: Battle Angel,404980543,85838210,0.21,319142333,0.79,2019
362,Godzilla: King of the Monsters,387300138,110500138,0.29,276800000,0.72,2019
366,1917,384579472,159227644,0.41,225351828,0.59,2019
381,Once Upon a Time in Hollywood,377617598,142502728,0.38,235114870,0.62,2019
401,Shazam!,367799011,140480049,0.38,227318962,0.62,2019
428,Dumbo,353284621,114766307,0.33,238518314,0.68,2019
481,John Wick: Chapter 3 - Parabellum,328349387,171015687,0.52,157333700,0.48,2019
483,Crazy Alien,327598891,-,-,327598891,1.00,2019
512,Knives Out,312897920,165363234,0.53,147534686,0.47,2019
630,Parasite,262716511,53369749,0.20,209346762,0.80,2019
636,Terminator: Dark Fate,261119292,62253077,0.24,198866215,0.76,2019
650,Us,256067149,175084580,0.68,80982569,0.32,2019
651,Pegasus,255863112,-,-,255863112,1.00,2019
657,Men in Black: International,253890701,80001807,0.32,173888894,0.69,2019
661,Dark Phoenix,252442974,65845974,0.26,186597000,0.74,2019
681,Glass,246999039,111048468,0.45,135950571,0.55,2019
690,The Bravest,245179562,290217,0.00,244889345,1.00,2019
741,Annabelle Comes Home,231252591,74152591,0.32,157100000,0.68,2019
765,Better Days,225918798,1921657,0.01,223997141,0.99,2019
766,Ford v Ferrari,225508210,117624357,0.52,107883853,0.48,2019
789,Little Women,218843645,108101214,0.49,110742431,0.51,2019
278,The Eight Hundred,461421559,372755,<0.1%,461048804,1.00,2020
285,Demon Slayer: Kimetsu no Yaiba - The Movie: Mugen Train,453210959,49505008,0.11,403705951,0.89,2020
314,Bad Boys for Life,426505244,206305244,0.48,220200000,0.52,2020
318,My People  My Homeland,422390820,-,-,422390820,1.00,2020
406,Tenet,365304105,58504105,0.16,306800000,0.84,2020
500,Sonic the Hedgehog,319715683,148974665,0.47,170741018,0.53,2020
663,Dolittle,251410631,77047065,0.31,174363566,0.69,2020
708,Legend of Deification,240646355,214670,<0.1%,240431685,1.00,2020
7,Spider-Man: No Way Home,1921847111,814115070,0.42,1107732041,0.58,2021
72,The Battle at Lake Changjin,902548476,342411,<0.1%,902206065,1.00,2021
96,Hi  Mom,822009764,-,-,822009764,1.00,2021
113,No Time to Die,774153007,160891007,0.21,613262000,0.79,2021
133,F9: The Fast Saga,726229501,173005945,0.24,553223556,0.76,2021
149,Detective Chinatown 3,686257563,-,-,686257563,1.00,2021
234,Venom: Let There Be Carnage,506863592,213550366,0.42,293313226,0.58,2021
269,Godzilla vs. Kong,470116094,100916094,0.22,369200000,0.79,2021
307,Shang-Chi and the Legend of the Ten Rings,432243292,224543292,0.52,207700000,0.48,2021
335,Sing 2,408402367,162790990,0.40,245611377,0.60,2021
347,Eternals,402064899,164870234,0.41,237194665,0.59,2021
348,Dune,402027830,108327830,0.27,293700000,0.73,2021
377,Black Widow,379751655,183651655,0.48,196100000,0.52,2021
475,Free Guy,331526598,121626598,0.37,209900000,0.63,2021
553,A Quiet Place Part II,297372261,160072261,0.54,137300000,0.46,2021
646,Encanto,256786742,96093622,0.37,160693120,0.63,2021
732,Cruella,233503234,86103234,0.37,147400000,0.63,2021
779,My Country  My Parents,221831086,177133,<0.1%,221653953,1.00,2021
781,Jungle Cruise,220889446,116987516,0.53,103901930,0.47,2021
3,Avatar: The Way of Water,2320250281,684075767,0.30,1636174514,0.71,2022
12,Top Gun: Maverick,1495696292,718732821,0.48,776963471,0.52,2022
53,Jurassic World Dominion,1001978080,376851080,0.38,625127000,0.62,2022
62,Doctor Strange in the Multiverse of Madness,955775804,411331607,0.43,544444197,0.57,2022
66,Minions: The Rise of Gru,939628210,369695210,0.39,569933000,0.61,2022
86,Black Panther: Wakanda Forever,859208836,453829060,0.53,405379776,0.47,2022
116,The Batman,772245583,369345583,0.48,402900000,0.52,2022
117,Thor: Love and Thunder,760928081,343256830,0.45,417671251,0.55,2022
170,Water Gate Bridge,626571697,117294,<0.1%,626454403,1.00,2022
257,Puss in Boots: The Last Wish,481080099,185535345,0.39,295544754,0.61,2022
280,Moon Man,460237662,-,-,460237662,1.00,2022
338,Fantastic Beasts: The Secrets of Dumbledore,407150844,95850844,0.24,311300000,0.77,2022
339,Uncharted,407141258,148648820,0.37,258492438,0.64,2022
341,Sonic the Hedgehog 2,405421518,190872904,0.47,214548614,0.53,2022
355,Black Adam,393252111,168152111,0.43,225100000,0.57,2022
574,Elvis,288670284,151040048,0.52,137630236,0.48,2022
672,The Bad Guys,250162278,97233630,0.39,152928648,0.61,2022
714,Bullet Train,239268602,103368602,0.43,135900000,0.57,2022
761,Lightyear,226425420,118307188,0.52,108118232,0.48,2022
796,Smile,217408513,105935048,0.49,111473465,0.51,2022
797,Too Cool to Kill,217254604,185882,<0.1%,217068722,1.00,2022
14,Barbie,1441769400,636169400,0.44,805600000,0.56,2023
16,The Super Mario Bros. Movie,1361888017,574934330,0.42,786953687,0.58,2023
63,Oppenheimer,950245530,325366530,0.34,624879000,0.66,2023
91,Guardians of the Galaxy Vol. 3,845555777,358995815,0.43,486559962,0.58,2023
140,Fast X,704709660,145960660,0.21,558749000,0.79,2023
147,Spider-Man: Across the Spider-Verse,690516673,381311319,0.55,309205354,0.45,2023
196,The Little Mermaid,569626289,298172056,0.52,271454233,0.48,2023
198,Mission: Impossible - Dead Reckoning Part One,567535383,172135383,0.30,395400000,0.70,2023
241,Elemental,495851987,154426697,0.31,341425290,0.69,2023
260,Ant-Man and the Wasp: Quantumania,476071180,214504909,0.45,261566271,0.55,2023
301,John Wick: Chapter 4,440146694,187131806,0.43,253014888,0.58,2023
303,Transformers: Rise of the Beasts,438966392,157066392,0.36,281900000,0.64,2023
353,Meg 2: The Trench,395000317,82600317,0.21,312400000,0.79,2023
369,Indiana Jones and the Dial of Destiny,383963057,174480468,0.45,209482589,0.55,2023
585,Five Nights at Freddy's,283107340,136209340,0.48,146898000,0.52,2023
596,Creed III,275248615,156248615,0.57,119000000,0.43,2023
608,The Flash,270633313,108133313,0.40,162500000,0.60,2023
616,The Nun II,268067073,86267073,0.32,181800000,0.68,2023
674,Taylor Swift: The Eras Tour,248956030,178265894,0.72,70690136,0.28,2023
678,Sound of Freedom,247801879,184174541,0.74,63627338,0.26,2023
